111111111111111111111111111111111111111111111111111111111111111111111111111111111111111111111111
100000000000000000000001000000000001000000000000000000000000001000000000000000000000000000100001
100000100000111110000001111111000000100000000000000000000000001000001111111110010000010000110001
100000000000100011100000000001000000100100000011111100111111001000001000000010011000000000110001
111110000000100100111000000001000000100100100010000000010001001100011000100010001000100010110001
100010000000100001000100000001000000100100000010000000010000001100011000000010001000100000000001
100010000000110010001100000001000000100100000010010000010000001000001010100010001000110000000001
101010010000010000011000000001111000100100000010000000010000001111111000000010000000010100000001
100010000000011011110000000000001000100100000010000000010000001110111000000010000000010000010001
100111111000001010000001111111101000100100010011011000010000000000000010001010000000000000110001
100100001000000000000001000000101000100100000001011011010000001111111000000110000110000001100001
100100101000000000011111000100101000100101000001100011110001111000001111111100000100000000000001
100100101000000000010000100000100000100100000001000000000001000000000011000000001100000100000001
100100101000000000010000001000100111100100000101000000000001000100000011000000011001000001000001
100100101111100111110100000000100000000100000001000000000001000000010001000000110000010000000001
101100100000000000000001000100100000000100000011000000100001000000000001011000100000010000001001
101000100010001000010000000000111111111100100010100010000001000010000001000000000100011000000001
101000100000000000000000000000000000000000010010000000100001011000000001001100000000001100000001
101011111111110001111111111100001000010000000010000010000011000001010011000000000000000110000001
101010000000010000000000000110000000000010000110001000000011000000000011000000001100000000000001
101000010010010100000000000011100000000000001100000000000000000001000011000000100000000000010001
101111001110010000001111000000111100000000011000100010000000011100000010000001100001000000010001
100001000000010000000000100010000111111111110000000000000011111100000110000111000000000000110001
111101001111110011110000010100000000000001000011000000011111111100000100001100000000000000100001
100001000000000010011110000000000001000000000000000111111000011110001100000000000000010001100001
101111000000000010000011100000000011000000000000011100000000000111101000110000001111110011010001
100000000001111110000000111000000110000001000001110110000000000000111000010011111100000110011001
100000000001000000000000001110000000000001000111000011000011111110000000010010000000000000001111
100000010001000000000000000011000000000001111100000000000110000011110000010000001000000000000011
101000000001000000001111000001111111111111100100010000011100000000011000010000011000000000000001
100001111111001110001001110000000000000000001100011000110000000000001100010000000000111010000001
100101000000000001001000111100000001000000000000001111100000001100001100011100000001100010000001
100001000000000001001000000111000011000000000000011110000001100001100100000000000111000010000001
101001000010000000001000000001111110000000000111110000000001100001100100000000000000000010000001
100011000100000000001100000000000111111111111100000000000000000000000100000000000000000010000001
100010001000000000001100000000000000000000000000000000000010001100010110000000110000000100000001
100010000000100010000100000000000000000000000000000000000010001100010010000001100000001000000001
100110000000100010000100000000000000000000000000000000000000000000000011010011000001111001010001
100010000001100010000100000000111111100011111111111000000001100001100000011110001111000000000001
110010110001000010000100001111110000100010000000011110000001100001100000000000001000000010101001
100010010001000010000100001111100000100010000000011111100000001100001100000001110000000001110001
100010010001000010000100001111000001100011000001100111111000000000011110100000000000000000000001
100010010001000010000100001111000011000001100001001001001111110000111000100000000000000000000001
100010010001100010000100011110000010000000100001001001000001111111100000111110000000000000000001
101010000000000110000100011110000010001000100001001001000000000000000000000011000000010001000001
100010000000000100000100011110000010001000100001001011000000000000000000000001000000000000000001
100110000000001100000100011110000010001000100000000000000000000001100000000001000001000000000001
100010000000011000000100111110000010000000100001001001000000011111111000000000000001100000010001
100010001000110000000100111110000011000001100001001001000000001111111100000101010000111000110001
110011111000100000000100011110000001111111000001001001000000011111110000000101000000001111100001
100000000000000000000100001110000000000000000001001011000000000001111000000111010000000000000001
100000000000000111111110000000000000000000000001100010000000000000000000000101010000000000000001
100000000000000000000001000000000000000000000000111110000000000000000000000101010000000000000001
111111111111111111111111111111111111111111111111111111111111111111111111111111111111111111111111