111111111111111111111111111111111111111111111111111111111111111111111111111111111111111111111111
100000000000000000000000000000000000000000000000000000000000000000000000000000000000000000000001
100000000000000000000000000000100000000000000000000000000000000000000000000000000000000000000001
100000000000000000000000001000110011100000000000000000000000000000000000000000000000000000000001
100000000000000000000000011000110110100000000000000000100000000000000011000000000000000000000001
100000000000000000000000011000011100100000000000000000100000000000000010000000000000000000000001
100000000000000000000000011000000001100000000000000000100000000000000100000000000000000000000001
100000000000011111100000011000000001000000000000000000111111111111111100000000000000000000000001
101111111111111100100000101000000011000000000000000000100000000000000000000000000000000000000001
100000000000000000100000101110000111000111000000000001100000000000000000000000000000000000000001
100000000000000000100001000011111001011111100000000001000000000000000000000000000000000000000001
100000000000000000100011000000000001100000100000000001000000000000000000000000000000000000000001
100010000000000000101110000000000011000000100000000001000000000000000000000000000000000000000001
100011111111000000111000000000000001000001100000000111000000000000000000000000000000000000000001
100010000001100000100000011100000011000010000000000101000000000000000000000000000000000000000001
100010000001000000100000000111111110000010000000001001000000000000000000000000000000000000000001
100010000001000000100000000010000000000110000000011001100000000000000000000000000000000000000001
100010000001000000100000000110000000000100000000110000100000000000000000000000000000000000000001
100110000001000000100000000100000000001100000011100000100000001000000000000000000000000000000001
100000000001000000100000001100000000011000000000000000110000001000000000000000000000000000000001
100000001111000011100000001100010000110000000000000000010000001000000000000000000000000000000001
100000001111111110000000011000010000000000000000000000001111101000000000000000000000000000000001
100000000000000000000001100000011000000000000000000000000000111000000000000000000000000000000001
100001000000000000000011000000001000000000000000000000000000001000000000000000000000000000000001
100001000000000000000010000000011000000100000000000000000000001100000000000000000000000000000001
100001000000000000000100000000010000000100000000000000000000000100000000000000000000000000000001
100001000000000000001100000001110000001111000000000000000000000100000000000000000000000000000001
100001100000000000001000000001000010011001100000000000000000000100000000000000000100000000000001
100001100000000000110000000001000011010001100000000000000000000100000000000000001100000000000001
100001111000000011000000000001000011111000100000000000000000000110000000000000011000000000000001
100001001111111100000000000001000010001100110000000000001110000110000000000000110000000000000001
100001000000000000000000000011000110000100010000000001111000000110000000000000100000000000000001
100010000000000000000000001110000100000100011000000001000000000100000000000001000000000000000001
100010000000000000000000001100000100000100001000000001100000000100000000000001000000000000000001
100010000000000000000000111000001100111100001100000001100000001100000000000110000000000000000001
100010000000000000000001101000001000000100000110000011110000011000000000001100000000000000000001
100011000000000000000110010000010000000100000011000110011111010000000000011000000000000000000001
100001111100001111111000110000100000000100000001111100000001111100000000110000000000000000000001
100000001111111110000000100001000000000100000000111100000000001110000000100000000000000000000001
100000000000000000000000100011000000011000000000011000000000000010000000100000000000000000000001
100000000000000000000001100010000001110000000000011000000000000001000000100000000000000000000001
100000000000000000000011000010000000000000100000001100000000000001100000100000000000000000000001
100000000000000000111110000110111000000111110000000110000000000000110011100000000000000000000001
100000000000011111100000000111001000000100010000000011100000000000011110000000000000000000000001
100000000111110000000000001100001000000110010000000000100000000000011000000000000000000000000001
100000111100100000000000110000001000000010010000000000100000000001110000000000000000000000000001
100000000000100000000000000000001100000010011000000000111100000011000000000000000000000000000001
100000000000100000000000000000000100000110001111100000000111100010000000000000000000000000000001
100000000000100000000000011111111111111100000011111000000000000010000000000000000000000000000001
100000000000111111111111110000000000000000000000001100000000000010000000000000000000000000000001
100000000000000000000000000000000000000000000000001111100000011110000000000000000000000000000001
100000000000000000000000000000000000000000000000000000000000000000000000000000000000000000000001
100000000000000000000000000000000000000000000000000000000000000000000000000000000000000000000001
111111111111111111111111111111111111111111111111111111111111111111111111111111111111111111111111