111111111111111111111111111111111111111111111111111111111111111111111111111111111111111111111111
100000000000000000000000000000000000000000000000000000000000000000000000000000000000000000000001
100000000000000000000000000000000000000000000000000000000000000000000000000000000000000000000001
100000000000000000000000000000000000000000000000000000000000000000000000000000000000000000000001
100000000000000000000000000000000000000000000000000000000000000000000000000000000000000000000001
100000000000000000000000000000000000000000000000000000000000000000000000000000000000000000000001
100000000000000000000000000000000000000000000000000000000000000000000000000000000000000000000001
100000000000000000000000000000000000000000000000000000000000000000000000000000000000000000000001
100000000000000000000000000000000000000000000000000000000000000000000000000000000000000000000001
100000000000000000000000000000000000000000000000000000000000000000000000000000000000000000000001
100000000000000000000000000000000000000000000000000000000000000000000000000000000000000000000001
100000000000000000000000000000000000000000000000000000000111110000000000000000000000000000000001
100000000000000000000000000000000000000000000000000000011100001100000000000000000000000000000001
100000000000000000010000001000001000000000000000000000010110000011000000000000000000000000000001
100000000000000000010000001000000000000000000000000000011100000000110000000000000000000000000001
100000000000000000010000001000000000000000000000000000101000000000010000000000000000000000000001
100000000000000000010000001000001000000000000000000001000000000000001000000000000000000000000001
100000000000000000010000001000001000000000000000000011000000000000000100000000000000000000000001
100000000000000000010000001000001000000000000000000010000010000010000100000000000000000000000001
100000000000000000010000001000001000000000000000000010000000000000000110000000000000000000000001
100000000000000000011111111000001000000000000000000010000000000000000010000000000000000000000001
100000000000000000010000001000001000000000000000000010000010000000000010000000000000000000000001
100000000000000000010000001000001000000000000000000011000011000001000010000000000000000000000001
100000000000000000010000001000001000000000000000000001000001110011000010000000000000000000000001
100000000000000000010000001000001000000000000000000000100000011110000010000000000000000000000001
100000000000000000010000001000001000000000000000000000110000000000000010000000000000000000000001
100000000000000000010000001000001000000000000000000000001000000000000110000000000000000000000001
100000000000000000010000001000001000000000000000000000000111000000001100000000000000000000000001
100000000000000000010000001000001000000000000000000000000001111101111000000000000000000000000001
100000000000000000010000001000001000000000000000000000000000000111000000000000000000000000000001
100000000000000000000000000000000000000000000000000000000000000000000000000000000000000000000001
100000000000000000000000000000000000000000000000000000000000000000000000000000000000000000000001
100000000000000000000000000000000000000000000000000000000000000000000000000000000000000000000001
100000000000000000000000000000000000000000000000000000000000000000000000000000000000000000000001
100000000000000000000000000000000000000000000000000000000000000000000000000000000000000000000001
100000000000000000000000000000000000000000000000000000000000000000000000000000000000000000000001
100000000000000000000000000000000000000000000000000000000000000000000000000000000000000000000001
100000000000000000000000000000000000000000000000000000000000000000000000000000000000000000000001
100000000000000000000000000000000000000000000000000000000000000000000000000000000000000000000001
100000000000000000000000000000000000000000000000000000000000000000000000000000000000000000000001
100000000000000000000000000000000000000000000000000000000000000000000000000000000000000000000001
100000000000000000000000000000000000000000000000000000000000000000000000000000000000000000000001
100000000000000000000000000000000000000000000000000000000000000000000000000000000000000000000001
100000000000000000000000000000000000000000000000000000000000000000000000000000000000000000000001
100000000000000000000000000000000000000000000000000000000000000000000000000000000000000000000001
100000000000000000000000000000000000000000000000000000000000000000000000000000000000000000000001
100000000000000000000000000000000000000000000000000000000000000000000000000000000000000000000001
100000000000000000000000000000000000000000000000000000000000000000000000000000000000000000000001
100000000000000000000000000000000000000000000000000000000000000000000000000000000000000000000001
100000000000000000000000000000000000000000000000000000000000000000000000000000000000000000000001
100000000000000000000000000000000000000000000000000000000000000000000000000000000000000000000001
100000000000000000000000000000000000000000000000000000000000000000000000000000000000000000000001
100000000000000000000000000000000000000000000000000000000000000000000000000000000000000000000001
111111111111111111111111111111111111111111111111111111111111111111111111111111111111111111111111