111111111111111111111111111111111111111111111111111111111111111111111111111111111111111111111111
100000000000000000000000000000000000000000000000000000000000000000000000000000000000000000000001
100000000000000000000000000000000000000000000000000000000000000000000000000000000000000000000001
100000000000000000000000000000000000000000000000000000000000000000000000000000000000000000000001
100000000000000000000000000000000110000000000000000000000000000000000000000000000000000000000001
100000000000000000000000000111111110000000000000000000000000000000000000000000000000000000000001
100000000000000000000111111100000000000000000000000000000000000000000000010101000011001100000001
100000000001111111110100000000000000000000000000000000000000000000000000010100000011001100000001
100001000000000000000000000000000000010000000000000000000000000000000000011101000000000000000001
100001000000000000000000000000000000000000011000000000000000000000000000010101000000110000000001
100001000000000000000000000000000000000000000101000000000000000000000000010101000000110000000001
100001000000000000000011111110000000000000000000010100000000000000000000000000000011111100000001
100001000010000000111110000000000000000000000000000001010000000000000000011111000011111100000001
100001000011111111000000000000000000000000000000000000000101100000000000000000000011001100000001
100001000000000000000000000000010000000000000000000000000000001001010000000000000011001100000001
100001000000000000000000000000011111000000000000000000000000000000000010100000000000000000000001
100000000000000000000000000000000000111000000111000000000000000000000000000100000000000000000001
100001000000000000000000000000000000000110000001110000000000000000000000000000100000000000000001
100001000000010000000000000000000000000001100000001110000000000000000000000000000100000000000001
100000100000011000000000000110000000000000110000000001110000000000000000000000000000000000000001
100000100000001100000000000000000000000000011000000000011110000000000000000000000000000000000001
100000100000000010000001000000000000000000000100000000000001000000000000000000000000000000000001
100000010000000011100001000000000000000000000010000000000000000000000000000000000000000000000001
100000010000000000110011000000000000000000000010000000000000000000000000000000000000000000000001
100000010000000000001110000000000000000000000001000000000000000000000000000000000000000000000001
100000001000000000011100000000000000000000000000110000000000000000000000000000000000000000000001
100000001100000000111001010100000000000000000000001100000110000000000000000000000000000000000001
100000000000000000000000000001111100000000000000000010000100000000000000000000000000000000000001
100000000000000010000000000000001000000000000000000001001000000000000000000000000000000000000001
100000000000000110000000000000000000000000000000000000110000000000000000000000000000000000000001
100000000000000100000000000000000000000000000000000000101000000000000000000000000000000000000001
100000000000000100000000000000000000000000000000000001000011000000000000000000000000000000000001
100000000000000000000000000000000000000000000000000010000000010000000000000000000000000000000001
100000000000000000000000000000000000000000000000001000000000001000000000000000000000000000000001
100000000000000000000000000000000000000000000000010000000000000010000000000000000000000000000001
100000000000000000000000010000000000000000000000000000000000000000100000000000000000000000000001
100000000000000000000000000000000000000000000000100000000000000000001000000000000000000000000001
100000000000000000000000001000000000000000000010000000000000000000000100000000000000000000000001
100000000000000000000000001000000000000000000100000000000000000000000001000000000000000000000001
100000000000000000000000000000000000000000000100000000000000000000000000010000000000000000000001
100000000000000000000000000100000000000000001000000000000000000000000000000000000000000000000001
100000000000000000000000000000000000000000010000000000000000000000000000000000000000000000000001
100000000000000000000000000011000000000000100000000000000000000000000000000000000000000000000001
100000000000000000000000000000100000000011000000000000000000000000000000000000000000000000000001
100000000000000000000000000000010100001110000000000000000000000000000000000000000000000000000001
100000000000000000000000000000000011111000000000000000000000000000000000000000000000000000000001
100000000000000000000000000000000000000000000000000000000000000000000000000000000000000000000001
100000000000000000000000000000000000000000000000000000000000000000000000000000000000000000000001
100000000000000000000000000000000000000000000000000000000000000000000000000000000000000000000001
100000000000000000000000000000000000000000000000000000000000000000000000000000000000000000000001
100000000000000000000000000000000000000000000000000000000000000000000000000000000000000000000001
100000000000000000000000000000000000000000000000000000000000000000000000000000000000000000000001
100000000000000000000000000000000000000000000000000000000000000000000000000000000000000000000001
111111111111111111111111111111111111111111111111111111111111111111111111111111111111111111111111